Date,Description,Debit,Credit,Balance
2025-01-03,makan makan,500.00,,500.00
2025-01-03,transport,90.00,,590.00
2025-01-03,daddy,4000.00,,4590.00
2025-01-03,flight,,300.00,4290.00
2025-01-03,part time,580.00,,4870.00
2025-01-03,new money,,700.00,4170.00
2025-01-03,GAMBLE,,600.00,3570.00
2025-01-03,eat,200.00,,3770.00
2025-01-03,Pokemon TCG,300.00,,4070.00
2025-01-03,food,,32.00,4038.00
2025-01-03,motel,211.00,,4249.00
2025-01-03,ink,333.00,,4582.00
